*Essential Vocabulary/Phrases
saán ka púpuntá | where are you going?
diyán lámang | just nearby
paumanhin | i am sorry (like when bumping into someone)
pakiraán pô | please let me pass
patawad pô | forgive me (when hurting someone)
aywan ko| i do not know | short: èwan ko
hindí ko alám | i do not know | short: di ko alám
ayaw akó | i do not like | ayòko
bahála na! | come what may!
kauntî lámang | just a little | short: Lang
kung mínsan | once in a while
gísing na! | wake up!
hindî bale! | never mind!
hindî namán| not so
hintáy ka! | wait for a moment! | short: teka!
huwag na salámat | no more thank you
bahálà ka | it is up to you
magmadali ká | hurry up | short: dali ka! | be quick you
mámayá na | for a while
marámig salamat | thank you so much
salámat | thank you | sa-LA-mat
saká na | later
sandalî lámang | just a moment | short: lang
síge na | go on

*More Essentials
sáyang | what a pity | what a loss
tahímik kayo | be silent
táma na | it is alright | it is enough
táyo na | let us go | short: Tena
túlog na | go to sleep
maráhil | maybe
oô sigúro | yes for sure
hindî akoo sigúro | i am not sure
sigúro | maybe
kataká-taká | it seems incredible
magalíng | outstanding | how skilled
nakayáyamót | it is annoying 
mabúhay | welcome! | literally: may you live long
mabuhay ang bagong kasal | may the newly weds live long
maligáyang batì | congratulations
pasensya na | sorry | patience now
gusto ko ng tinipay | i like bread
ayaw mo ng gatas | you do not like milk
pwede niya | she/he can
kailangan nila | they need | they should
dapat namin | we should

