*Greetings
magandáng áraw| good day
magandáng umága | good morning
magandáng tanghálì | good noon |covers lunchtime |from 11am to 1pm
magandáng hápon | good afternoon
magandáng gabí | good evening
kumusta ka na? | how are you?
kumusta na po kayo | how are you? (polite)
mabuti ikaw? | fine you?
mabuti rin | fine too
paálam | goodbye
ingat | take care

*Common Expressions
salámat | thank you | sa-LA-mat
saán ka púpuntá | where are you going?
saán kayó púpuntá? | where are you going sir/madam?
saán ka nanggáling? | where have you been?
diyán lámang | just nearby
paumanhin aalis na ako | excuse me i will leave now
paumanhin lálabas lamang ako sandalî | excuse me i will go out for a while
paumanhin | i am sorry | like when bumping into someone
pakiraán pô | please let me pass
mawaláng-gálang pô | may i lose my courtesy | ibeg your pardon | when interrupting someone to get attention
mawaláng-gálang pô paano pumuntá sa 5 ave | excuse me how do i get to 5 ave
patawad pô | forgive me | when hurting someone
patawárin ninyó akó | forgive me | when hurting someone
pasibtabi pô | please set aside | excuse the forthcoming offensive situation


Talaga? | Really?
Pasensya na | Sorry | Patience now
Gusto ko ng tinipay | I like bread
Ayaw mo ng gatas | You do not like milk
Pwede niya | She/He can
Kailangan nila | They need | They should
Dapat namin | We should

*Common Questions
Anong pangalan mo? | What is your name?
Ako si Javier | I am Javier
Taga-saan ka? | Where are you from?
Taga-earth ako | I am from earth

*Question feelings
Kumusta ang ulo mo? | How is your head?
Masakit ba ang ulo mo? | Does your head hurt?